%s used of %s %s %%=%s تستخدم %s (%s %%)
---= تستخدم 
Active tunnels= الفعالة Tunnels الـ 
Activity=النشاط
ago=مُنذ
Airflow=تدفق الهواء
All Apps= التطبيقات
All VMs= VMs الـ
Battery charge= مستوى الشحن 
BIOS dated= Bios تأريخ الـ 
Click to toggle details= انقر لتغير التفاصيل
Completed= انتهى
Counters info= معلومات المؤشرات
Current operation %s on %s=العملية الحالية %s على **%s**
custom image= تخصيص صورة
Data is invalid= البيانات غير صحيحة 
default image= الصورة الافتراضية
Docker Containers= حاويات الدوكر
Due in= السبب بذالك
Elapsed time= الوقت الذي انقضى
Errors info= معلومات الاخطاء
Estimated finish= الوقت المفترض للانتهاء
failed device= فشل الجهاز
Fan count= عدد المراوح
FAN= مروحة
Finding %s error=جاري البحث: **%s** خطاء
Finding %s errors=جاري البحث: **%s** اخطاء
General info= المعلومات العامة
Go to cache settings= إنتقل الى اعدادات الكاش
Go to CPU pinning settings= إنتقل الى اعدادت مثبت المعالج
Go to disk settings= إنتقل الى اعدادت القرص
Go to Docker settings= إنتقل الى اعدادات الدوكر
Go to fan settings= إنتقل  الى اعدادات المروحة
Go to identification settings= إنتقل الى اعدادات التعريف
Go to network settings= إنتقل الى اعدادات الشبكة
Go to scheduler settings= إنتقل الى اعدادات الجدول
Go to Share settings= إنتقل الى اعدادات المشاركة
Go to UPS settings= إنتقل الى اعدادات حماية الطاقة
Go to User settings= إنتقل الى اعدادات المستخدم
Go to VM settings= VM إنتقل الى اعدادات الـ
Go to VPN settings= VPN إنتقل الى اعدادات الـ
Handshake= المصافحة
has= لدية
healthy= الاداء
heat warning= تحذير من الحرارة
Hide details= اخفي التفاصيل
in progress= جاري العمل
Inactive tunnels= غير نشطة Tunnels الـ
inactive= غير نشط
Inbound= الترافك الداخل
invalid device= جهاز غير صالح
invalid devices= الاجهزة غير صالحة
Last check completed on %s=الفحص الاخير انتهي في**%s**
Last check incomplete on %s=الفحص الاخير لم ينتهي **%s**
Last checked on %s=اخر فحص كان في **%s**
Maximum size= اقصى حجم مسموح به
Mode of operation= طريقة العملية
Next check scheduled on %s=جدولة الفحص القادم في  **%s**
No docker containers defined= لم يتعرف على حاويات الدوكر
No running docker containers= لايوجد حاويات دوكر تعمل
No running virtual machines= تعمل VMs لايوجد 
No shares present= لاتوجد مشاركات
No virtual machines defined= VMsلم يتم التعرف على الـ
Nominal power= الطاقة الاسمية 
not received= لم تٌستلم
Outbound= الترافك الخارجي
Overall Load= الحمل الكُلي
Parity disk not present= القرص الشبية غير موجود
Parity disks not present= الاقراص الشبية غير موجودة
Parity has not been checked yet= لم يتم التحقق من التشابة لحد الان
Parity is degraded= التشابة يتدهور 
Power= الطاقة
Put system to sleep= وضع النظام على السكون
Reboot the system= اعادة تشتغيل النظام
Receive counters= المؤشرات المستلمة
Received packets= الباكيتس المُستلمة 
Runtime left= وقت التشغيل المُنقضي
Scheduled parity check is disabled= جدولة فحص التشابة معطلة
Select Case Model= اختر نوع الحالة
Share count %s with %s cache only and %s encrypted=عدد المشاركات: %s مع %s  ذاكرة التخزين المؤقتة فقط %s مشفرة
Show details= عرض التفاصيل
Show Information= عرض المعلومات
Shutdown the system= ايقاف النظام
SMART error= خطأ في نظام المراقبة الذكي
SMART= نظام المراقبة الذكي
sn=s/n
Start the array= تشتغيل المصفوفة
Started only= بدء فقط
Stop the array= ايقاف المصفوفه
This will put the system to sleep= سوف يؤدي الى وضع النظام في حالة السكون
This will reboot the system= سوف يؤدي الى اعادة تشتغيل النظام
This will shutdown the system= سوف يؤدي الى ايقاف النظام
This will start the array= سوف يؤدي الى تشتغيل الصفيفة
This will stop the array= سوف يؤدي الى ايقاف الصفيفه
Transmit counters= مؤشرات الارسال
Transmitted packets= الحُزم المُرسلة
UPS Load= UPS حمل الـ  
UPS status= UPS حالة الـ
Usable size= الحجم الصالح للاستخدام
User count %s with %s unprotected=عدد المستخدمين: %sمع %s غير محمي
utilization warning= تحذير الاستخدام
View Running Processes= عرض العلميات الجارية
Virtual Machines= VMS الـ
