; Translation Credit.  Will appear in CA's credits
translationCredit=<Zyzto> (العربية)
Cancel=إلغاء

; My PSAs / banners
Happy New Year=كل عام وانتم بخير
Happy Holidays from Andrew, Tracey, and family=اعياد سعيدة من اندرو، تريسي و العائلة
Please Enjoy Responsibly=رجاءً افرحوا بمسؤولية
Popup Blocked CA requires popups to be enabled under certain circumstances You must white list your server within your browser to allow popups=النوافذ المنبثقة متطلبة لعمل صفحة التطبيقات العامة يرجى السماح بها من خلال المتصفح
Docker Service Not Enabled - Only Plugins Available To Be Installed Or Managed=التطبيقات غير مفعلة، الإضافات متاحة حاليا
Community Applications works best when cookies are enabled in your browser Certain features may not be available=صفحة التطبيقات العامة تعمل بشكل أفضل عندما تفعل الكوكيز
Backup Server Active Some icons may not appear, and plugin installations may be affected=السيرفر البديل نشط، بعض الأيقونات ربما لا تظهر، وتثبيت الإضافات ربما يتأثر

; Sorting Options
Sorting options=خيارات الترتيب
Sorting options unavailable=خيارات الترتيب غير متاحة
Sort By Name Ascending=ترتيب بالأسماء تصاعدي
Sort By Name Descending=ترتيب بالأسماء تنازلي
Sort By Downloads=ترتيب بعدد التحميلات
Sort By Trend=ترتيب بالرائج
Sort By Date Added=ترتيب بالتاريخ
; Initial disclaimer translations
Disclaimer=تنبيه
All applications listed here are 3rd party additions to Unraid Neither the authors of Community Applications nor Limetech make any warranty as to the suitability of any application listed here=جميع التطبيقات هنا، من صنع مطورين لا يتنموا إلى Limetech ، لا نتحمل او اي مطور للتطبيقات هذه لأي مشاكل او عدم توافق ينتج من استخدامها
Every attempt is made to ensure that only safe and compatible applications are present=نحاول بقدر الإمكان على التأكد من كل تطبيق متواجد انه أمن ومتوافق
Application Policy=شروط التطبيقات
I Understand=أقر بالشروط
Installations of apps disabled You must accept the warning to be able to install applications=للتثبيت أي تطبيق مخفي يجب عليك ان توافق على التحذير المقدم
Click here=اضغط هنا

; Plugin Disclaimer
Community Applications contains both docker containers and plugin applications Plugins are designed for OS enhancements, and run with full privileges on your system and are clearly identified within CA=التطبيقات العامة تشمل تطبيقات وإضافات مصممة لتحسين النظام، وتعمل بكامل الصلاحيات على جهازك و واضحة في صفحة التطبيقات العامة
Plugin Note=مذكرات الإضافة

; Multi Install
Install Plugin Applications=ثبت **تطبيقات/إضافات**

; Searches
Search=بحث
Please enter search term=ادخل كلمة للبحث
Click Here To Get More Results From DockerHub=اضغط هنا للحصول على نتائج من DockerHub
No Matching Applications Found On Docker Hub=لا توجد نتائج من DockerHub
No Matching Applications Found=لا توجد نتائج

; Install Plugin title of openbox
Install Plugin=تثبيت الإضافة

; Remove App from previously installed
Delete Template=حذف القالب
Yes, delete it=نعم، احذفه

; Uninstall popup
Uninstall Application=حذف تطبيق
Yes uninstall it=نعم، احذفه

; Remove Private Application
Remove Private Application=حذف تطبيق
Yes, remove it=نعم، احذفه

; App Pinning
Click to pin this application=اضغط لتعليق التطبيق
Click to unpin this application=اضغط لإلغاء تعليق التطبيق

; Branch installations
Choose A Branch To Install=اختر اي فرع

; Multiple application installs
; no apps selected
Install Selected Applications=تثبيت التطبيقات المختارة

Yes, install it=نعم، ثبتها

; Multi-install popup
Yes, install them=نعم، ثبتهم
Cookies not enabled Plugins must be separately installed from docker applications=الكوكيز غير مفعلة الإضافات يجب ثبتيها منفصلة عن التطبيقات
Docker applications will be installed utilizing the most recently saved template with no user input on your part=التطبيقات سيتم تثبيتها بإستخدام احدث قالب محفوظ بدون تدخل المستخدم
Updating Support Links=تحديث روابط الدعم
Finished Installing If the DONE button did not appear, then you will need to click the red X in the top right corner=إنتهى التثبيت، اذا لم يظهر زر **تم**، إذن اضغط **X** في اعلى النافذة

; error messages
No data was returned It is probable that another browser session has rebooted your server Reloading this browser tab will probably fix this error=لا توجد معلومات للعرض بالأغلب أن صفحة أخرى طلبت إعادة تشغيل السيرفر، يرجى تحديث الصفحة لحل المشكلة
An error occurred Could not find any %s Apps=حدث خطأ لم نستطع إيجاد %s تطبيقات
Download of appfeed failed=فشل تحميل صفحة التطبيقات
; the %s here refers to a function being called
Something really went wrong here=حدث خطأ
Post the ENTIRE contents of this message in the Community Applications Support Thread=انسخ رسالة الخطأ كاملة للمنتديات الدعم
Unknown error happened Please post a screenshot in the support thread of the Statistics screen=حدث خطأ غير معروف ارسل صورة من الخطأ في صفحة الإحصائيات
Something really wrong happened Reloading the Apps tab will probably fix the problem=حدث خطأ، تحديث الصفحة ربما يصلح المشكلة
This plugin has a duplicated name from another plugin %s This will impact your ability to install both plugins simultaneously=إسم الإضافة متكرر %s ، سوف يأثر هذا على تثبيتهما

; CA Sections Keep the length reasonable
MENU=القائمة
Installed Apps=التطبيقات المثبتة
Previous Apps=التطبيقات السابقة
Pinned Apps=التطبيقات المعلقة
CATEGORIES=التصنفيات
New Apps=التطبيقات الجديدة
Updated Apps=التطبيقات المحدثة
Random Apps=تطبيقات عشوائية
Top New Installs=اعلى تطبيقات مثبتة حديثة
Trending Apps=التطبيقات الرائجة
All Apps=جميع التطبيقات
OTHER=أخرى
Statistics=إحصائيات
Credits=إنجاز
Support=الدعم
VERSION=الإصدار
Change Log=سجل التغييرات

; Credits
Development=التطوير
Additional Contributions=مشاركات
GUI Layout Design=مصمم الواجهة
Application Feed=مصدر التطبيقات
Additional Testing=تجربة
Moderation=ادارة
Additional Libraries=مكاتب إضافية
Copyright=حقوق
Translation=ترجمة

; Statistics page
Deprecated Applications are able to still be installed if you have previously had them installed New installations of these applications are blocked unless you enable Display Deprecated Applications within CAs General Settings=التطبيقات منتهية الدعم يمكن إعادة ثبيتها اذا كانت مثبتة سابقا لكن اي تطبيق أخر منتهي الدعم يتطلب تفعيل **إظهار التطبيقات منتهية الدعم** من خلال الإعدادات العامة من التطبيقات العامة
The following applications are blacklisted CA will never allow you to install or reinstall these applications=هذه التطبيقات محجوبة ولن تستطيع ابدا تثبيتها او إعادة تثبيتها
While highly not recommended to do, incompatible applications can be installed by enabling Display Incompatible Applications within CAs General Settings=**لا ينصح** بتثبيت تطبيقات غير متوافقة، لكن يمكن تثبيتها بعد تغيير إعدادات العرض
This display is informational ONLY=تظهر معلومات فقط
unknown=غير معروف
Last Change To Application Feed=أخر تعديل في صفحة التطبيقات
Number Of Docker Applications=عدد التطبيقات
Number Of Plugin Applications=عدد الإضافات
Number Of Templates=عدد القوالب
Number Of Repositories=عدد المصادر
Number Of Private Docker Applications=عدد التطبيقات الشخصية
Number Of Invalid Templates=عدد القوالب الغير متوافقة
Number Of Template Errors=عدد أخطاء القوالب
Number Of Blacklisted Apps=عدد التطبيقات المحجوبة
Number Of Incompatible Applications=عدد التطبيقات غير المكتملة
Number Of Deprecated Applications=عدد التطبيقات منتهية الدعم
Number Of Moderation Entries=عدد التغييرات الإدارية
Primary Server=السيرفر الرئيسي
Backup Server=السيرفر البديل

; Statistics Popup Titles
Repository List=قائمة المصادر
All Invalid Templates Found=جميع القوالب الغير متوافقة
Template Errors=أخطاء القوالب
All Moderation Entries=التعديلات الإدارية

; Statistics Popup
No invalid templates found=لا يوجد قوالب غير متوافقة
These templates are invalid and the application they are referring to is unknown=القوالب غير متوافقة و التطبيق غير معروف
No templates were automatically fixed=لم يتم إصلاح أي قالب
All of these errors found have been fixed automatically=جميع الأخطاء تم إصلاحها تلقائيًا
Note that many of these errors can be avoided by following the directions=تنبيه يمكن تجنب أغلب الأخطاء بإتباع التعليمات
HERE=**هنا**
The following plugins have duplicated filenames and are not able to be installed simultaneously=هذه الإضافات متكررة الأسماء ولا يمكن تثبيتها
The following docker applications refer to the same docker repository but may have subtle changes in the template to warrant this=التطبيقات هذه تعود لنفس المصدر لكن تحمل تغييرات للقالب
If any of these entries are incorrect then contact the moderators of CA to discuss=ان كان هناك اي خطأ في البيانات الرجاء التواصل مع إدارة التطبيقات العامة
Global Repository Comments=تعليقات المصادر العامة
Applied to all applications=(Applied to all applications)
Individual Application Moderation=

; Misc
Community Applications Changelog=تغييرات التطبيقات العامة

; Categories try not to be excessively long This is displayed on the left of CA screen

Backup=نسخ إحتياطي
Cloud=سحابي
Downloaders=التحميلات
Game Servers=سيرفرات العاب
Home Automation=البيت الذكي
Media Applications=تطبيقات وسائط
Books=كتب
Music=موسيقى
Photos=صور
Video=فديوهات
Other=أخرى
Media Servers=سيرفرات وسائط
Network Services=خدمات الشبكة
DNS=DNS
FTP=FTP
Management=إدارة
Messenger=تواصل
Proxy=بروكسي
VOIP=VOIP
VPN=VPN
Web=ويب
Productivity=إنشائية
Security=أمن
Tools Utilities=أدوات / خدمات
System=نظام
Themes=سمات
Utilities=خدمات
Private Apps=تطبيقات شخصية
Uncategorized=غير مصنف

; Categories displayed within a popup or on the card
GameServers=سيرفرات العاب
HomeAutomation=البيت الذكي
MediaApp=تطبيق وسائط
MediaAppBooks=تطبيق وسائط:كتب
MediaAppMusic=تطبيق وسائط:موسيقى
MediaAppPhotos=تطبيق وسائط:صور
MediaAppVideo=تطبيق وسائط:فديو
MediaAppOther=تطبيق وسائط:أخرى
MediaServer=سيرفر وسائط متعددة
MediaServerBooks=سيرفر وسائط:كتب
MediaServerMusic=سيرفر وسائط:موسيقى
MediaServerPhotos=سيرفر وسائط:صور
MediaServerVideo=سيرفر وسائط:فديو
MediaServerOther=سيرفر وسائط:أخرى
Network=شبكة
NetworkDNS=شبكة:DNS
NetworkFTP=شبكة:FTP
NetworkManagement=شبكة:إدارة
NetworkProxy=شبكة:بروكسي
NetworkVOIP=شبكة:VOIP
NetworkVPN=شبكة:VPN
NetworkWeb=شبكة:ويب
NetworkOther=شبكة:أخرى
ToolsSystem=أدوات:نظم
ToolsThemes=أدوات:سمات
ToolsUtilities=أدوات:خدمات
Other=أخرى
OtherUncategorized=أخرى:غير مصنفة
and %s more=و أخرى %s

; App Popup Related
Donate To Author=تبرع للناشر
Donate To Maintainer=تبرع للمطور
Author=ناشر
Maintainer=مطور
DockerHub=DockerHub
Application Template=قوالب التطبيقات
Base OS=النظام الأساسي
DockerHub Stars=إحصائيات DockerHub
Added to CA=أضف إلى التطبيقات العامة
Date Updated=تاريخ الإضافة
Current Version=الإصدار الحالي
Minimum OS=أقل نسخة مسموحة
Max OS=أعلى نسخة مسموحة
Total Downloads=عدد التحميلات
Licence=الرخصة
30 Day Trend=إحصائيات 30 يوم
Ranked #%s=قيم **#%s**
; as in Trending up or down arrow
Trending %s=الشهرة %s
; as in As of some date
As of %s=(As of %s)
This application template has been blacklisted=التطبيق/قالب تم حجبه
This application template has been deprecated=التطبيق/قالب منتهي الدعم
This application is not compatible with your version of Unraid=التطبيق غير متوافق مع إصدار النظام
Another browser tab or device has updated the displayed templates Some actions are not available=تم تغيير القالب من خلال نافذة أخرى، بعض الخيارات غير متوفرة
Reinstall default=إعادة تثبيت (إفتراضي)
WebUI=الواجهة
Reinstall=إعادة تثبيت
Install=تثبيت
Project=مشروع
Install Using The Templates Default Tag=إستخدم القالب الإفتراضي للتثبيت
Moderator Comments=تعليقات الإدارة:
Note not all authors keep up to date on change logs=**تنبيه** الناشرون عدد منهم لا ينشروا تغييرات الإصدارات
Note not all maintainers keep up to date on change logs=**تنبيه** المطورون عدد منهم لا ينشروا تغييرات الإصدارات
;the following if using a space you MUST use nbsp but keep it down to one word if at all possible
Donate=تبرع
Currently Installed Version=الإصدار الحالي
Install The Update=تحديث
; as in you have the latest version already installed
Latest Version=أجدد إصدار
Multi Language Support=دعم لغات متعددة
; as in more than 100000
More than %s=اكثر من %s

; Graphs
Trend Per Month=الشهرة بالشهر
Downloads Per Month=التحميل كل شهر
Total Downloads=إجمالي التحميلات

; Multi install script
Installing docker applications %s=تثبيت تطبيق %s
Starting %s=يبدأ %s
%s failed to start You should install it by itself to fix the errors=التطبيق %s فشل التثبيت يجب تثبيته منفصلُا
Setting installed applications to autostart=التطبيقات المثبتة ستعمل تلقائيًا مع التشغيل
Docker Application Installation finished=إنتهى تثبيت التطبيقات

; Application Cards
Private dockerHub Conversion=مصدر خاص
Go to the project page=إذهب إلى صفحة المشروع
Go to the support thread=إذهب إلى صفحة الدعم
Uninstall Application=إزالة التطبيق
Remove Private Application=إزالة تطبيق خاص
Remove Application From List=إزالة التطبيق من القائمة
Check off to select multiple reinstalls=إختر لإعادة تثبيت تطبيقات
Go to the plugin settings=إذهب إلى إعدادات الإضافة
Click to reinstall the application using default values=إعادة التثبيت بالإعدادات الإفتراضية
Click to edit the application values=اضغط لتعديل قيم التطبيق
Click to reinstall=اضغط لإعادة التثبيت
Click to install=اضغط للتثبيت
Install plugin=تثبيت إضافة
Click to go to the WebUI=اضغط لذهاب إلى موقع التطبيق
This application has been marked as being Beta=التطبيق تم تصنيف beta
This application template has been deprecated=قالب التطبيق منتهي الدعم
This application is not compatible with your version of Unraid=التطبيق غير متوافق مع النظام
This application template has been blacklisted=قالب التطبيق مجحوب
Search for more applications from %s=إبحث عن تطبيقات من %s
Click for more information=اضغط لمعلومات إضافية

; Dockerhub searches
Search For Containers From %s=إبحث عن تطبيقات من %s
Search for similar containers=إبحث عن تطبيقات متشابهة

; Page Navigation
Displaying %s - %s of %s=عرض %1$s - %2$s (من %3$s)

Updating Content=تحديث المحتوى
Language=اللغة
Switch to this language=تحول إلى هذه اللغة
Country Code=رمز الدولة
Install Language Pack=تثبيت لغة
Remove Language Pack=حذف لغة
Update Language Pack=تحديث لغة
Installed Version=تثبيت إصدار

; Help Text
This chooses how to sort the results=حدد ترتيب النتائج
These icons respectively will Install or Edit an application=هذه الإيقونات ستثبت او تحدث تطبيقًا
Clicking these icons will take you to an applications GUI or settings=الضغط هنا سينقلك لصفحة التطبيقات العامة
This will update an application=هذا سيحدث تطبيقًا
This will take you to the appropriate support thread for an application=هذا سينقلك لصفحة الدعم
This will immediately switch to the language=هذا سيحول اللغة
This will take you to the project page for an application=هذا سينقلك لصفحة المشروع
Clicking this icon will uninstall the application or delete it from the lists depending upon your current section=ضغط هذه الأيقونة سيزيل التطبيق او يحذفه من القائمة بناءً على خيارك
Clicking these icons will pin or unpin an application for later viewer from the Pinned Apps section=ضغط هذه الأيقونات سيعلق التطبيق للمشاهدة لاحقًا
Clicking this will display more information about the application NOTE You can also click on the applications icon to display more information=ضغط هذا سيظهر معلومات إضافية عن التطبيق، ويمكن أيضا الضغط على ايقونة التطبيق للحصول على المعلومات
Clicking this will display any warnings or extra comments about the application=ضغط هذا سيظهر تحذيرات و تعليقات إضافة عن التطبيق
On the previous apps section you can select multiple applications to install simultaneously=في صفحة التطبيقات السابقة يمكنك تحديد عدة تطبيقات لتثبت في نفس الوقت
This is the recommended version to install by the application author themselves=هذا الإصدار الموصى بتثبته من الناشر
For support for this plugin visit=لمزيد من الدعم زر
To view the policies Community Applications has=لقرائة شروط التطبيقات العامة